image_name,part,section,min_height,max_height,diff_height,piece_position,class,image_id
P01_001_0,1,0,181,200,19,Down,2,1
P01_001_1,1,1,198,208,10,Down,1,1
P01_001_2,1,2,204,214,10,Down,1,1
P01_001_3,1,3,200,212,12,Down,1,1
P01_002_0,1,0,232,238,6,Down,1,2
P01_002_1,1,1,235,242,7,Down,1,2
P01_002_2,1,2,242,248,6,Down,1,2
P01_002_3,1,3,243,249,6,Down,1,2
P01_003_0,1,0,232,238,6,Down,1,3
P01_003_1,1,1,237,238,1,Down,1,3
P01_003_2,1,2,236,242,6,Down,1,3
P01_003_3,1,3,237,241,4,Down,1,3
P01_004_0,1,0,681,685,4,Up,1,4
P01_004_1,1,1,676,691,15,Up,1,4
P01_004_2,1,2,690,695,5,Up,1,4
P01_004_3,1,3,670,697,27,Up,1,4
P01_005_0,1,0,662,696,34,Up,1,5
P01_005_1,1,1,686,701,15,Up,1,5
P01_005_2,1,2,695,697,2,Up,1,5
P01_005_3,1,3,695,703,8,Up,1,5
P01_006_0,1,0,186,190,4,Down,1,6
P01_006_1,1,1,191,196,5,Down,1,6
P01_006_2,1,2,190,194,4,Down,1,6
P01_006_3,1,3,193,195,2,Down,1,6
P01_007_0,1,0,182,190,8,Down,1,7
P01_007_1,1,1,183,186,3,Down,1,7
P01_007_2,1,2,184,196,12,Down,1,7
P01_007_3,1,3,195,198,3,Down,1,7
P01_008_0,1,0,251,257,6,Down,1,8
P01_008_1,1,1,250,257,7,Down,1,8
P01_008_2,1,2,254,258,4,Down,1,8
P01_008_3,1,3,255,260,5,Down,1,8
P01_009_0,1,0,245,250,5,Down,1,9
P01_009_1,1,1,247,251,4,Down,1,9
P01_009_2,1,2,250,258,8,Down,1,9
P01_009_3,1,3,247,256,9,Down,1,9
P01_010_0,1,0,309,315,6,Down,1,10
P01_010_1,1,1,310,315,5,Down,1,10
P01_010_2,1,2,306,315,9,Down,1,10
P01_010_3,1,3,297,306,9,Down,1,10
P01_011_0,1,0,324,334,10,Down,1,11
P01_011_1,1,1,311,324,13,Down,2,11
P01_011_2,1,2,312,317,5,Down,1,11
P01_011_3,1,3,305,318,13,Down,1,11
P01_012_0,1,0,713,715,2,Up,1,12
P01_012_1,1,1,708,713,5,Up,1,12
P01_012_2,1,2,710,710,0,Down,1,12
P01_012_3,1,3,705,709,4,Up,1,12
P01_013_0,1,0,293,298,5,Down,1,13
P01_013_1,1,1,290,294,4,Down,1,13
P01_013_2,1,2,286,296,10,Down,1,13
P01_013_3,1,3,280,292,12,Down,1,13
P01_014_0,1,0,679,680,1,Up,1,14
P01_014_1,1,1,668,677,9,Up,2,14
P01_014_2,1,2,670,674,4,Up,1,14
P01_014_3,1,3,639,676,37,Up,2,14
P01_015_0,1,0,796,804,8,Up,1,15
P01_015_1,1,1,786,799,13,Up,2,15
P01_015_2,1,2,780,808,28,Up,2,15
P01_015_3,1,3,791,801,10,Up,1,15
P01_016_0,1,0,332,339,7,Down,1,16
P01_016_1,1,1,333,338,5,Down,1,16
P01_016_2,1,2,330,340,10,Down,1,16
P01_016_3,1,3,333,341,8,Down,1,16
P01_017_0,1,0,668,674,6,Up,1,17
P01_017_1,1,1,669,675,6,Up,2,17
P01_017_2,1,2,668,669,1,Up,1,17
P01_017_3,1,3,666,671,5,Up,1,17
P01_018_0,1,0,290,304,14,Down,1,18
P01_018_1,1,1,288,302,14,Down,1,18
P01_018_2,1,2,290,304,14,Down,1,18
P01_018_3,1,3,308,311,3,Down,1,18
P01_019_0,1,0,298,309,11,Down,1,19
P01_019_1,1,1,302,306,4,Down,1,19
P01_019_2,1,2,304,310,6,Down,1,19
P01_019_3,1,3,308,312,4,Down,1,19
P01_020_0,1,0,703,714,11,Up,2,20
P01_020_1,1,1,700,711,11,Up,2,20
P01_020_2,1,2,703,711,8,Up,2,20
P01_020_3,1,3,692,706,14,Up,2,20
P01_021_0,1,0,274,282,8,Down,1,21
P01_021_1,1,1,276,290,14,Down,1,21
P01_021_2,1,2,287,290,3,Down,1,21
P01_021_3,1,3,286,298,12,Down,1,21
P01_022_0,1,0,701,714,13,Up,1,22
P01_022_1,1,1,703,714,11,Up,2,22
P01_022_2,1,2,702,714,12,Up,2,22
P01_022_3,1,3,703,711,8,Up,2,22
P01_023_0,1,0,703,713,10,Up,2,23
P01_023_1,1,1,697,708,11,Up,2,23
P01_023_2,1,2,697,700,3,Up,2,23
P01_023_3,1,3,683,703,20,Up,2,23
P01_024_0,1,0,226,241,15,Down,1,24
P01_024_1,1,1,230,236,6,Down,1,24
P01_024_2,1,2,227,237,10,Down,1,24
P01_024_3,1,3,216,234,18,Down,2,24
P01_025_0,1,0,230,238,8,Down,1,25
P01_025_1,1,1,231,237,6,Down,1,25
P01_025_2,1,2,232,236,4,Down,1,25
P01_025_3,1,3,232,237,5,Down,1,25
P01_026_0,1,0,607,612,5,Up,1,26
P01_026_1,1,1,607,615,8,Up,2,26
P01_026_2,1,2,603,618,15,Up,2,26
P01_026_3,1,3,582,605,23,Up,2,26
P01_027_0,1,0,224,235,11,Down,1,27
P01_027_1,1,1,226,241,15,Down,2,27
P01_027_2,1,2,232,240,8,Down,1,27
P01_027_3,1,3,237,242,5,Down,1,27
P01_028_0,1,0,228,230,2,Down,1,28
P01_028_1,1,1,228,242,14,Down,1,28
P01_028_2,1,2,230,240,10,Down,2,28
P01_028_3,1,3,236,242,6,Down,2,28
P01_029_0,1,0,625,655,30,Up,3,29
P01_029_1,1,1,655,659,4,Up,1,29
P01_029_2,1,2,648,661,13,Up,2,29
P01_029_3,1,3,655,666,11,Up,1,29
P01_030_0,1,0,747,756,9,Up,1,30
P01_030_1,1,1,748,755,7,Up,1,30
P01_030_2,1,2,750,761,11,Up,1,30
P01_030_3,1,3,758,778,20,Up,2,30
P01_031_0,1,0,711,717,6,Up,1,31
P01_031_1,1,1,711,717,6,Up,1,31
P01_031_2,1,2,717,726,9,Up,1,31
P01_031_3,1,3,717,723,6,Up,1,31
P01_032_0,1,0,718,721,3,Up,1,32
P01_032_1,1,1,717,723,6,Up,1,32
P01_032_2,1,2,715,722,7,Up,1,32
P01_032_3,1,3,721,727,6,Up,1,32
P01_033_0,1,0,261,266,5,Down,1,33
P01_033_1,1,1,264,269,5,Down,1,33
P01_033_2,1,2,267,275,8,Down,1,33
P01_033_3,1,3,272,280,8,Down,1,33
P01_034_0,1,0,256,264,8,Down,1,34
P01_034_1,1,1,261,264,3,Down,1,34
P01_034_2,1,2,261,272,11,Down,1,34
P01_034_3,1,3,262,294,32,Down,1,34
P01_035_0,1,0,765,766,1,Up,1,35
P01_035_1,1,1,765,769,4,Up,1,35
P01_035_2,1,2,765,770,5,Up,1,35
P01_035_3,1,3,767,773,6,Up,1,35
P01_036_0,1,0,761,764,3,Up,1,36
P01_036_1,1,1,759,775,16,Up,1,36
P01_036_2,1,2,773,777,4,Up,1,36
P01_036_3,1,3,769,778,9,Up,1,36
P01_037_0,1,0,700,705,5,Up,1,37
P01_037_1,1,1,702,706,4,Up,1,37
P01_037_2,1,2,701,708,7,Up,1,37
P01_037_3,1,3,699,708,9,Up,1,37
P01_038_0,1,0,703,716,13,Up,1,38
P01_038_1,1,1,699,713,14,Up,1,38
P01_038_2,1,2,709,711,2,Up,1,38
P01_038_3,1,3,709,717,8,Up,1,38
P01_039_0,1,0,655,658,3,Up,1,39
P01_039_1,1,1,644,653,9,Up,1,39
P01_039_2,1,2,640,649,9,Up,1,39
P01_039_3,1,3,636,649,13,Up,1,39
P01_040_0,1,0,645,652,7,Up,1,40
P01_040_1,1,1,642,647,5,Up,1,40
P01_040_2,1,2,634,648,14,Up,2,40
P01_040_3,1,3,631,636,5,Up,1,40
P01_041_0,1,0,250,253,3,Down,1,41
P01_041_1,1,1,247,264,17,Down,1,41
P01_041_2,1,2,246,251,5,Down,1,41
P01_041_3,1,3,244,246,2,Down,1,41
P01_042_0,1,0,669,679,10,Up,1,42
P01_042_1,1,1,668,672,4,Up,1,42
P01_042_2,1,2,665,669,4,Up,1,42
P01_042_3,1,3,661,670,9,Up,1,42
P01_043_0,1,0,285,290,5,Down,1,43
P01_043_1,1,1,285,288,3,Down,1,43
P01_043_2,1,2,274,288,14,Down,2,43
P01_043_3,1,3,279,280,1,Down,1,43
P01_044_0,1,0,157,168,11,Down,1,44
P01_044_1,1,1,152,196,44,Down,2,44
P01_044_2,1,2,158,176,18,Down,2,44
P01_044_3,1,3,150,166,16,Down,1,44
P01_045_0,1,0,619,626,7,Up,1,45
P01_045_1,1,1,621,631,10,Up,1,45
P01_045_2,1,2,621,626,5,Up,1,45
P01_045_3,1,3,617,626,9,Up,1,45
P01_046_0,1,0,285,290,5,Down,1,46
P01_046_1,1,1,280,288,8,Down,1,46
P01_046_2,1,2,277,288,11,Down,1,46
P01_046_3,1,3,285,290,5,Down,1,46
P01_047_0,1,0,288,291,3,Down,1,47
P01_047_1,1,1,289,292,3,Down,1,47
P01_047_2,1,2,284,290,6,Down,2,47
P01_047_3,1,3,283,290,7,Down,2,47
P01_048_0,1,0,649,653,4,Up,1,48
P01_048_1,1,1,651,663,12,Up,1,48
P01_048_2,1,2,657,663,6,Up,1,48
P01_048_3,1,3,657,666,9,Up,1,48
P01_049_0,1,0,647,652,5,Up,1,49
P01_049_1,1,1,649,655,6,Up,1,49
P01_049_2,1,2,654,657,3,Up,1,49
P01_049_3,1,3,650,662,12,Up,1,49
P01_050_0,1,0,253,267,14,Down,1,50
P01_050_1,1,1,248,256,8,Down,1,50
P01_050_2,1,2,248,259,11,Down,2,50
P01_050_3,1,3,246,256,10,Down,1,50
P01_051_0,1,0,661,673,12,Up,1,51
P01_051_1,1,1,669,672,3,Up,1,51
P01_051_2,1,2,669,679,10,Up,1,51
P01_051_3,1,3,670,683,13,Up,1,51
P01_052_0,1,0,248,256,8,Down,1,52
P01_052_1,1,1,245,257,12,Down,1,52
P01_052_2,1,2,244,256,12,Down,2,52
P01_052_3,1,3,244,263,19,Down,2,52
P01_053_0,1,0,262,262,0,Down,1,53
P01_053_1,1,1,259,267,8,Down,1,53
P01_053_2,1,2,248,262,14,Down,1,53
P01_053_3,1,3,248,256,8,Down,2,53
P01_054_0,1,0,725,743,18,Up,2,54
P01_054_1,1,1,725,743,18,Up,2,54
P01_054_2,1,2,724,729,5,Up,1,54
P01_054_3,1,3,726,746,20,Up,2,54
P01_055_0,1,0,721,727,6,Up,1,55
P01_055_1,1,1,723,727,4,Up,1,55
P01_055_2,1,2,722,727,5,Up,2,55
P01_055_3,1,3,723,735,12,Up,1,55
P01_056_0,1,0,352,376,24,Down,2,56
P01_056_1,1,1,341,355,14,Down,2,56
P01_056_2,1,2,346,352,6,Down,2,56
P01_056_3,1,3,347,350,3,Down,2,56
P01_057_0,1,0,717,722,5,Up,2,57
P01_057_1,1,1,719,727,8,Up,1,57
P01_057_2,1,2,724,732,8,Up,1,57
P01_057_3,1,3,729,733,4,Up,1,57
P01_058_0,1,0,717,723,6,Up,1,58
P01_058_1,1,1,721,729,8,Up,2,58
P01_058_2,1,2,717,731,14,Up,2,58
P01_058_3,1,3,729,732,3,Up,1,58
P01_059_0,1,0,293,304,11,Down,2,59
P01_059_1,1,1,298,314,16,Down,2,59
P01_059_2,1,2,300,304,4,Down,1,59
P01_059_3,1,3,304,320,16,Down,2,59
P02_060_0,2,0,300,352,52,Down,3,60
P02_060_1,2,1,344,363,19,Down,3,60
P02_060_2,2,2,318,361,43,Down,3,60
P02_060_3,2,3,320,344,24,Down,3,60
P02_061_0,2,0,543,559,16,Up,3,61
P02_061_1,2,1,559,574,15,Up,2,61
P02_061_2,2,2,575,578,3,Up,1,61
P02_061_3,2,3,575,581,6,Up,2,61
P02_062_0,2,0,610,656,46,Up,3,62
P02_062_1,2,1,596,639,43,Up,3,62
P02_062_2,2,2,593,615,22,Up,3,62
P02_062_3,2,3,607,659,52,Up,3,62
P02_063_0,2,0,378,382,4,Down,2,63
P02_063_1,2,1,381,384,3,Down,1,63
P02_063_2,2,2,384,400,16,Down,2,63
P02_063_3,2,3,400,416,16,Down,2,63
P03_064_0,3,0,571,607,36,Up,3,64
P03_064_1,3,1,573,594,21,Up,3,64
P03_064_2,3,2,556,595,39,Up,3,64
P03_064_3,3,3,551,592,41,Up,3,64
P03_065_0,3,0,548,567,19,Up,2,65
P03_065_1,3,1,523,567,44,Up,3,65
P03_065_2,3,2,534,561,27,Up,3,65
P03_065_3,3,3,519,548,29,Up,3,65
P03_066_0,3,0,559,578,19,Up,3,66
P03_066_1,3,1,533,574,41,Up,3,66
P03_066_2,3,2,543,564,21,Up,3,66
P03_066_3,3,3,535,559,24,Up,2,66
P03_067_0,3,0,599,631,32,Up,3,67
P03_067_1,3,1,578,609,31,Up,3,67
P03_067_2,3,2,579,596,17,Up,2,67
P03_068_0,3,0,636,655,19,Up,3,68
P03_068_1,3,1,639,665,26,Up,2,68
P03_068_2,3,2,639,667,28,Up,3,68
P03_068_3,3,3,660,663,3,Up,1,68
P03_069_0,3,0,639,649,10,Up,2,69
P03_069_1,3,1,643,660,17,Up,2,69
P03_069_2,3,2,647,657,10,Up,2,69
P03_069_3,3,3,642,655,13,Up,1,69
P03_070_0,3,0,635,639,4,Up,1,70
P03_070_1,3,1,634,641,7,Up,1,70
P03_070_2,3,2,637,641,4,Up,1,70
P03_070_3,3,3,639,642,3,Up,1,70
P03_071_0,3,0,630,637,7,Up,1,71
P03_071_1,3,1,627,637,10,Up,2,71
P03_071_2,3,2,627,637,10,Up,2,71
P03_071_3,3,3,627,634,7,Up,2,71
P03_072_0,3,0,607,620,13,Up,2,72
P03_072_1,3,1,595,627,32,Up,3,72
P03_072_2,3,2,612,621,9,Up,2,72
P03_072_3,3,3,615,623,8,Up,3,72
P03_073_0,3,0,623,643,20,Up,3,73
P03_073_1,3,1,629,645,16,Up,2,73
P03_073_2,3,2,626,644,18,Up,3,73
P03_073_3,3,3,637,641,4,Up,2,73
P03_074_0,3,0,595,618,23,Up,3,74
P03_074_1,3,1,583,613,30,Up,3,74
P03_074_2,3,2,543,599,56,Up,3,74
P03_074_3,3,3,567,589,22,Up,3,74
P03_075_0,3,0,367,393,26,Down,3,75
P03_075_1,3,1,364,385,21,Down,3,75
P03_075_2,3,2,358,389,31,Down,3,75
P03_075_3,3,3,347,390,43,Down,3,75
P03_076_0,3,0,397,440,43,Down,3,76
P03_076_1,3,1,398,425,27,Down,3,76
P03_076_2,3,2,392,440,48,Down,3,76
P03_076_3,3,3,390,403,13,Down,3,76
P03_077_0,3,0,400,418,18,Down,3,77
P03_077_1,3,1,396,416,20,Down,3,77
P03_077_2,3,2,384,424,40,Down,3,77
P03_077_3,3,3,382,400,18,Down,3,77
P03_078_0,3,0,344,357,13,Down,3,78
P03_078_1,3,1,336,344,8,Down,2,78
P03_078_2,3,2,331,337,6,Down,1,78
P03_078_3,3,3,333,357,24,Down,2,78
P03_079_0,3,0,296,299,3,Down,1,79
P03_079_1,3,1,292,320,28,Down,3,79
P03_079_2,3,2,294,306,12,Down,3,79
P03_079_3,3,3,304,373,69,Down,3,79
P03_080_0,3,0,227,238,11,Down,2,80
P03_080_1,3,1,220,234,14,Down,2,80
P03_080_2,3,2,221,230,9,Down,1,80
P03_080_3,3,3,224,229,5,Down,2,80
P03_081_0,3,0,218,232,14,Down,2,81
P03_081_1,3,1,216,224,8,Down,2,81
P03_081_2,3,2,216,224,8,Down,2,81
P03_081_3,3,3,220,234,14,Down,2,81
P03_082_0,3,0,304,320,16,Down,2,82
P03_082_1,3,1,302,312,10,Down,2,82
P03_082_2,3,2,306,315,9,Down,2,82
P03_082_3,3,3,306,320,14,Down,2,82
P03_083_0,3,0,318,324,6,Down,1,83
P03_083_1,3,1,317,320,3,Down,1,83
P03_083_2,3,2,318,333,15,Down,1,83
P03_083_3,3,3,320,323,3,Down,2,83
P03_084_0,3,0,296,304,8,Down,1,84
P03_084_1,3,1,298,305,7,Down,2,84
P03_084_2,3,2,299,310,11,Down,3,84
P03_084_3,3,3,302,325,23,Down,3,84
P03_085_0,3,0,245,299,54,Down,3,85
P03_085_1,3,1,227,245,18,Down,3,85
P03_085_2,3,2,229,235,6,Down,3,85
P03_085_3,3,3,237,256,19,Down,3,85
P03_086_0,3,0,456,489,33,Down,3,86
P03_086_1,3,1,453,494,41,Down,3,86
P03_086_2,3,2,452,482,30,Down,3,86
P03_086_3,3,3,458,468,10,Down,3,86
P03_087_0,3,0,325,332,7,Down,2,87
P03_087_1,3,1,322,332,10,Down,2,87
P03_087_2,3,2,320,332,12,Down,1,87
P03_087_3,3,3,322,329,7,Down,2,87
P03_088_0,3,0,336,352,16,Down,2,88
P03_088_1,3,1,338,347,9,Down,2,88
P03_088_2,3,2,336,370,34,Down,3,88
P03_088_3,3,3,340,353,13,Down,2,88
P03_089_0,3,0,318,324,6,Down,2,89
P03_089_1,3,1,315,333,18,Down,3,89
P03_089_2,3,2,313,330,17,Down,2,89
P03_089_3,3,3,316,338,22,Down,2,89
P03_090_0,3,0,335,352,17,Down,2,90
P03_090_1,3,1,331,361,30,Down,3,90
P03_090_2,3,2,333,334,1,Down,1,90
P03_090_3,3,3,335,339,4,Down,2,90
P03_091_0,3,0,336,348,12,Down,2,91
P03_091_1,3,1,336,350,14,Down,3,91
P03_091_2,3,2,331,344,13,Down,2,91
P03_091_3,3,3,338,354,16,Down,3,91
P03_092_0,3,0,290,352,62,Down,3,92
P03_092_1,3,1,278,318,40,Down,3,92
P03_092_2,3,2,279,286,7,Down,2,92
P03_092_3,3,3,278,334,56,Down,3,92
P03_093_0,3,0,336,344,8,Down,1,93
P03_093_1,3,1,337,341,4,Down,1,93
P03_093_2,3,2,337,344,7,Down,2,93
P03_093_3,3,3,336,350,14,Down,2,93
P03_094_0,3,0,368,384,16,Down,3,94
P03_094_1,3,1,355,382,27,Down,3,94
P03_094_2,3,2,350,369,19,Down,3,94
P03_094_3,3,3,344,356,12,Down,3,94
P03_095_0,3,0,370,389,19,Down,3,95
P03_095_1,3,1,360,408,48,Down,3,95
P03_095_2,3,2,346,377,31,Down,3,95
P03_095_3,3,3,341,363,22,Down,3,95
P05_096_0,5,0,398,416,18,Down,3,96
P05_096_1,5,1,372,394,22,Down,3,96
P05_096_2,5,2,348,373,25,Down,3,96
P05_096_3,5,3,325,358,33,Down,3,96
P05_097_0,5,0,411,440,29,Down,3,97
P05_097_1,5,1,388,408,20,Down,3,97
P05_097_2,5,2,361,390,29,Down,3,97
P05_097_3,5,3,334,360,26,Down,3,97
P05_098_0,5,0,605,630,25,Up,3,98
P05_098_1,5,1,552,597,45,Up,3,98
P05_098_2,5,2,545,572,27,Up,3,98
P05_098_3,5,3,505,542,37,Up,3,98
P05_099_0,5,0,494,526,32,Up,3,99
P05_099_1,5,1,462,497,35,Up,3,99
P05_099_2,5,2,425,490,65,Up,3,99
P05_099_3,5,3,401,443,42,Up,3,99
P05_100_0,5,0,369,394,25,Down,3,100
P05_100_1,5,1,349,367,18,Down,3,100
P05_100_2,5,2,333,350,17,Down,3,100
P05_100_3,5,3,289,332,43,Down,3,100
P05_101_0,5,0,298,304,6,Down,2,101
P05_101_1,5,1,296,304,8,Down,2,101
P05_101_2,5,2,304,306,2,Down,1,101
P05_101_3,5,3,304,307,3,Down,1,101
P05_102_0,5,0,301,303,2,Down,2,102
P05_102_1,5,1,292,302,10,Down,2,102
P05_102_2,5,2,301,312,11,Down,1,102
P05_102_3,5,3,302,314,12,Down,1,102
P05_103_0,5,0,405,430,25,Down,2,103
P05_103_1,5,1,373,414,41,Down,2,103
P05_103_2,5,2,350,382,32,Down,2,103
P05_103_3,5,3,332,333,1,Down,2,103
P05_104_0,5,0,575,605,30,Up,3,104
P05_104_1,5,1,535,583,48,Up,3,104
P05_104_2,5,2,516,548,32,Up,3,104
P05_104_3,5,3,383,516,133,Up,3,104
P05_105_0,5,0,599,615,16,Up,3,105
P05_105_1,5,1,559,599,40,Up,3,105
P05_105_2,5,2,515,563,48,Up,3,105
P05_105_3,5,3,475,527,52,Up,3,105
P05_106_0,5,0,408,424,16,Down,3,106
P05_106_1,5,1,370,406,36,Down,3,106
P05_106_2,5,2,360,373,13,Down,3,106
P05_106_3,5,3,328,365,37,Down,3,106
P05_107_0,5,0,601,635,34,Up,3,107
P05_107_1,5,1,587,610,23,Up,3,107
P05_107_2,5,2,565,587,22,Up,3,107
P05_107_3,5,3,543,561,18,Up,3,107
P05_108_0,5,0,581,623,42,Up,3,108
P05_108_1,5,1,563,579,16,Up,3,108
P05_108_2,5,2,543,566,23,Up,3,108
P05_108_3,5,3,518,543,25,Up,3,108
P05_109_0,5,0,360,410,50,Down,3,109
P05_109_1,5,1,328,363,35,Down,3,109
P05_109_2,5,2,288,328,40,Down,3,109
P05_109_3,5,3,256,304,48,Down,3,109
P05_110_0,5,0,653,655,2,Up,1,110
P05_110_1,5,1,653,655,2,Up,1,110
P05_110_2,5,2,655,661,6,Up,1,110
P05_110_3,5,3,655,662,7,Up,2,110
P05_111_0,5,0,657,663,6,Up,2,111
P05_111_1,5,1,655,658,3,Up,1,111
P05_111_2,5,2,650,668,18,Up,1,111
P05_111_3,5,3,657,667,10,Up,2,111
P05_112_0,5,0,551,577,26,Up,2,112
P05_112_1,5,1,519,551,32,Up,2,112
P05_112_2,5,2,487,529,42,Up,2,112
P05_112_3,5,3,473,496,23,Up,2,112
P05_113_0,5,0,443,592,149,Down,3,113
P05_113_1,5,1,411,442,31,Down,3,113
P05_113_2,5,2,374,424,50,Down,3,113
P05_113_3,5,3,352,384,32,Down,3,113
P05_114_0,5,0,615,647,32,Up,3,114
P05_114_1,5,1,583,610,27,Up,3,114
P05_114_2,5,2,561,589,28,Up,3,114
P05_114_3,5,3,536,570,34,Up,3,114
P06_115_0,6,0,408,436,28,Down,3,115
P06_115_1,6,1,382,406,24,Down,3,115
P06_115_2,6,2,365,381,16,Down,3,115
P06_115_3,6,3,274,360,86,Down,3,115
P06_116_0,6,0,216,218,2,Down,1,116
P06_116_1,6,1,216,217,1,Down,1,116
P06_116_2,6,2,214,218,4,Down,1,116
P06_116_3,6,3,211,213,2,Down,1,116
P06_117_0,6,0,278,282,4,Down,1,117
P06_117_1,6,1,278,288,10,Down,1,117
P06_117_2,6,2,280,288,8,Down,1,117
P06_117_3,6,3,279,281,2,Down,1,117
P06_118_0,6,0,240,252,12,Down,1,118
P06_118_1,6,1,240,244,4,Down,1,118
P06_118_2,6,2,243,245,2,Down,1,118
P06_118_3,6,3,244,244,0,Down,1,118
P06_119_0,6,0,560,600,40,Up,2,119
P06_119_1,6,1,541,565,24,Up,2,119
P06_119_2,6,2,494,539,45,Up,2,119
P06_119_3,6,3,472,502,30,Up,2,119
P06_120_0,6,0,601,685,84,Up,3,120
P06_120_1,6,1,577,599,22,Up,2,120
P06_120_2,6,2,553,577,24,Up,2,120
P06_120_3,6,3,523,551,28,Up,2,120
P06_121_0,6,0,746,748,2,Up,1,121
P06_121_1,6,1,742,745,3,Up,1,121
P06_121_2,6,2,742,743,1,Up,1,121
P06_121_3,6,3,741,744,3,Up,1,121
P06_122_0,6,0,678,680,2,Up,1,122
P06_122_1,6,1,671,679,8,Up,1,122
P06_122_2,6,2,673,677,4,Up,1,122
P06_122_3,6,3,677,679,2,Up,1,122
P06_123_0,6,0,715,715,0,Up,1,123
P06_123_1,6,1,711,716,5,Up,1,123
P06_123_2,6,2,714,719,5,Up,1,123
P06_123_3,6,3,713,720,7,Up,1,123
P06_124_0,6,0,335,372,37,Down,2,124
P06_124_1,6,1,304,328,24,Down,2,124
P06_124_2,6,2,277,302,25,Down,2,124
P06_124_3,6,3,240,272,32,Down,3,124
P07_125_0,7,0,436,527,91,Up,3,125
P07_125_1,7,1,413,433,20,Up,2,125
P07_125_2,7,2,383,413,30,Up,3,125
P07_125_3,7,3,335,383,48,Up,3,125
P07_126_0,7,0,367,394,27,Up,3,126
P07_126_1,7,1,341,369,28,Up,3,126
P07_126_2,7,2,316,338,22,Up,2,126
P07_126_3,7,3,290,310,20,Up,2,126
P07_127_0,7,0,274,362,88,Up,3,127
P07_127_1,7,1,249,271,22,Up,2,127
P07_127_2,7,2,219,249,30,Up,2,127
P07_127_3,7,3,170,218,48,Up,3,127
P07_128_0,7,0,576,616,40,Down,3,128
P07_128_1,7,1,546,576,30,Down,2,128
P07_128_2,7,2,526,545,19,Down,2,128
P07_128_3,7,3,432,523,91,Down,3,128
P07_129_0,7,0,649,668,19,Down,2,129
P07_129_1,7,1,620,645,25,Down,2,129
P07_129_2,7,2,588,618,30,Down,3,129
P07_129_3,7,3,560,592,32,Down,3,129
P08_130_0,8,0,721,732,11,Up,2,130
P08_130_1,8,1,719,724,5,Up,1,130
P08_130_2,8,2,711,721,10,Up,2,130
P08_130_3,8,3,719,732,13,Up,2,130
P08_131_0,8,0,747,759,12,Up,2,131
P08_131_1,8,1,745,761,16,Up,2,131
P08_131_2,8,2,735,753,18,Up,2,131
P08_131_3,8,3,731,743,12,Up,2,131
P08_132_0,8,0,676,689,13,Up,2,132
P08_132_1,8,1,671,680,9,Up,2,132
P08_132_2,8,2,671,675,4,Up,1,132
P08_132_3,8,3,674,681,7,Up,1,132
P08_133_0,8,0,659,665,6,Up,1,133
P08_133_1,8,1,655,662,7,Up,1,133
P08_133_2,8,2,651,663,12,Up,1,133
P08_133_3,8,3,651,655,4,Up,1,133
P08_134_0,8,0,690,701,11,Up,1,134
P08_134_1,8,1,689,695,6,Up,1,134
P08_134_2,8,2,687,695,8,Up,1,134
P08_134_3,8,3,662,692,30,Up,3,134
P08_135_0,8,0,727,741,14,Up,2,135
P08_135_1,8,1,711,725,14,Up,2,135
P08_135_2,8,2,710,714,4,Up,1,135
P08_135_3,8,3,703,715,12,Up,2,135
P08_136_0,8,0,232,240,8,Down,2,136
P08_136_1,8,1,237,248,11,Down,2,136
P08_136_2,8,2,235,240,5,Down,2,136
P08_136_3,8,3,227,238,11,Down,2,136
P08_137_0,8,0,218,232,14,Down,2,137
P08_137_1,8,1,206,226,20,Down,2,137
P08_137_2,8,2,196,214,18,Down,2,137
P08_137_3,8,3,200,213,13,Down,2,137
P08_138_0,8,0,186,192,6,Down,2,138
P08_138_1,8,1,185,194,9,Down,1,138
P08_138_2,8,2,181,193,12,Down,1,138
P08_138_3,8,3,171,192,21,Down,2,138
P08_139_0,8,0,278,292,14,Down,2,139
P08_139_1,8,1,265,283,18,Down,2,139
P08_139_2,8,2,266,272,6,Down,1,139
P08_139_3,8,3,262,266,4,Down,1,139
P08_140_0,8,0,254,264,10,Down,2,140
P08_140_1,8,1,252,262,10,Down,2,140
P08_140_2,8,2,247,254,7,Down,2,140
P08_140_3,8,3,234,248,14,Down,2,140
P08_141_0,8,0,276,285,9,Down,1,141
P08_141_1,8,1,284,288,4,Down,1,141
P08_141_2,8,2,279,288,9,Down,2,141
P08_141_3,8,3,270,283,13,Down,2,141
P08_142_0,8,0,304,308,4,Down,1,142
P08_142_1,8,1,300,308,8,Down,2,142
P08_142_2,8,2,298,304,6,Down,1,142
P08_142_3,8,3,293,298,5,Down,1,142
P08_143_0,8,0,267,301,34,Down,3,143
P08_143_1,8,1,263,270,7,Down,2,143
P08_143_2,8,2,264,270,6,Down,2,143
P08_143_3,8,3,258,268,10,Down,2,143
P08_144_0,8,0,244,254,10,Down,2,144
P08_144_1,8,1,245,248,3,Down,2,144
P08_144_2,8,2,234,248,14,Down,2,144
P08_144_3,8,3,218,230,12,Down,2,144
P10_145_0,10,0,634,663,29,Up,2,145
P10_145_1,10,1,641,649,8,Up,2,145
P10_145_2,10,2,631,650,19,Up,2,145
P10_145_3,10,3,642,655,13,Up,2,145
P10_146_0,10,0,304,318,14,Down,2,146
P10_146_1,10,1,304,317,13,Down,2,146
P10_146_2,10,2,310,322,12,Down,2,146
P10_146_3,10,3,302,323,21,Down,2,146
P12_147_0,12,0,639,666,27,Up,3,147
P12_147_1,12,1,651,661,10,Up,2,147
P12_147_2,12,2,647,656,9,Up,2,147
P12_147_3,12,3,631,700,69,Up,3,147
P12_148_0,12,0,659,673,14,Up,2,148
P12_148_1,12,1,658,669,11,Up,2,148
P12_148_2,12,2,660,668,8,Up,1,148
P12_148_3,12,3,652,666,14,Up,2,148
P12_149_0,12,0,671,683,12,Up,2,149
P12_149_1,12,1,679,717,38,Up,2,149
P12_149_2,12,2,655,669,14,Up,2,149
P12_149_3,12,3,647,661,14,Up,2,149
P12_150_0,12,0,795,799,4,Up,1,150
P12_150_1,12,1,789,795,6,Up,1,150
P12_150_2,12,2,789,795,6,Up,1,150
P12_150_3,12,3,780,789,9,Up,1,150
P12_151_0,12,0,613,663,50,Up,3,151
P12_151_1,12,1,613,628,15,Up,3,151
P12_151_2,12,2,615,626,11,Up,3,151
P12_151_3,12,3,615,628,13,Up,3,151
P12_152_0,12,0,763,767,4,Up,2,152
P12_152_1,12,1,759,764,5,Up,2,152
P12_152_2,12,2,759,761,2,Up,1,152
P12_152_3,12,3,751,757,6,Up,2,152
P12_153_0,12,0,759,761,2,Up,1,153
P12_153_1,12,1,759,762,3,Up,1,153
P12_153_2,12,2,751,757,6,Up,1,153
P12_153_3,12,3,747,753,6,Up,1,153
P12_154_0,12,0,823,827,4,Up,1,154
P12_154_1,12,1,820,825,5,Up,1,154
P12_154_2,12,2,813,819,6,Up,1,154
P12_154_3,12,3,803,811,8,Up,1,154
P12_155_0,12,0,772,783,11,Up,1,155
P12_155_1,12,1,770,784,14,Up,2,155
P12_155_2,12,2,771,783,12,Up,2,155
P12_155_3,12,3,763,775,12,Up,1,155
P12_156_0,12,0,773,783,10,Up,1,156
P12_156_1,12,1,767,783,16,Up,3,156
P12_156_2,12,2,777,783,6,Up,1,156
P12_156_3,12,3,773,778,5,Up,1,156
P12_157_0,12,0,782,783,1,Up,1,157
P12_157_1,12,1,778,781,3,Up,1,157
P12_157_2,12,2,772,778,6,Up,1,157
P12_157_3,12,3,765,772,7,Up,1,157
P12_158_0,12,0,783,786,3,Up,1,158
P12_158_1,12,1,765,783,18,Up,1,158
P12_158_2,12,2,767,779,12,Up,2,158
P12_158_3,12,3,767,774,7,Up,1,158
P12_159_0,12,0,887,890,3,Up,1,159
P12_159_1,12,1,855,887,32,Up,3,159
P12_159_2,12,2,841,877,36,Up,3,159
P12_159_3,12,3,871,879,8,Up,1,159
P12_160_0,12,0,803,807,4,Up,1,160
P12_160_1,12,1,798,802,4,Up,1,160
P12_160_2,12,2,790,799,9,Up,1,160
P12_160_3,12,3,775,787,12,Up,2,160
P12_161_0,12,0,791,805,14,Up,3,161
P12_161_1,12,1,791,803,12,Up,2,161
P12_161_2,12,2,799,804,5,Up,1,161
P12_161_3,12,3,791,799,8,Up,1,161
P12_162_0,12,0,845,847,2,Up,1,162
P12_162_1,12,1,844,855,11,Up,1,162
P12_162_2,12,2,839,855,16,Up,1,162
P12_162_3,12,3,817,839,22,Up,3,162
P12_163_0,12,0,839,853,14,Up,3,163
P12_163_1,12,1,849,855,6,Up,1,163
P12_163_2,12,2,844,847,3,Up,1,163
P12_163_3,12,3,825,845,20,Up,3,163
P12_164_0,12,0,714,731,17,Up,2,164
P12_164_1,12,1,729,732,3,Up,1,164
P12_164_2,12,2,725,729,4,Up,1,164
P12_164_3,12,3,714,725,11,Up,1,164
P12_165_0,12,0,691,703,12,Up,2,165
P12_165_1,12,1,691,699,8,Up,1,165
P12_165_2,12,2,693,701,8,Up,1,165
P12_165_3,12,3,683,692,9,Up,1,165
P12_166_0,12,0,751,756,5,Up,1,166
P12_166_1,12,1,749,754,5,Up,1,166
P12_166_2,12,2,740,749,9,Up,1,166
P12_166_3,12,3,732,746,14,Up,1,166
P12_167_0,12,0,823,828,5,Up,1,167
P12_167_1,12,1,823,827,4,Up,1,167
P12_167_2,12,2,817,823,6,Up,1,167
P12_167_3,12,3,807,817,10,Up,1,167
P12_168_0,12,0,706,709,3,Up,1,168
P12_168_1,12,1,701,709,8,Up,1,168
P12_168_2,12,2,703,706,3,Up,1,168
P12_168_3,12,3,699,703,4,Up,1,168
P12_169_0,12,0,639,647,8,Up,1,169
P12_169_1,12,1,639,653,14,Up,1,169
P12_169_2,12,2,645,652,7,Up,1,169
P12_169_3,12,3,647,655,8,Up,1,169
P12_170_0,12,0,662,683,21,Up,2,170
P12_170_1,12,1,657,677,20,Up,2,170
P12_170_2,12,2,653,676,23,Up,2,170
P12_170_3,12,3,646,671,25,Up,2,170
P12_171_0,12,0,783,787,4,Up,1,171
P12_171_1,12,1,772,781,9,Up,1,171
P12_171_2,12,2,756,773,17,Up,2,171
P12_171_3,12,3,759,767,8,Up,1,171
P12_172_0,12,0,799,815,16,Up,2,172
P12_172_1,12,1,804,815,11,Up,2,172
P12_172_2,12,2,807,816,9,Up,2,172
P12_172_3,12,3,794,810,16,Up,2,172
P12_173_0,12,0,599,617,18,Up,2,173
P12_173_1,12,1,606,617,11,Up,2,173
P12_173_2,12,2,612,622,10,Up,2,173
P12_173_3,12,3,600,613,13,Up,2,173
P12_174_0,12,0,310,328,18,Down,3,174
P12_174_1,12,1,293,312,19,Down,2,174
P12_174_2,12,2,298,307,9,Down,2,174
P12_174_3,12,3,293,384,91,Down,3,174
P12_175_0,12,0,293,306,13,Down,2,175
P12_175_1,12,1,291,298,7,Down,2,175
P12_175_2,12,2,290,300,10,Down,2,175
P12_175_3,12,3,286,299,13,Down,2,175
P12_176_0,12,0,298,312,14,Down,2,176
P12_176_1,12,1,291,304,13,Down,2,176
P12_176_2,12,2,242,280,38,Down,2,176
P12_176_3,12,3,276,288,12,Down,2,176
P12_177_0,12,0,170,179,9,Down,1,177
P12_177_1,12,1,164,172,8,Down,1,177
P12_177_2,12,2,164,171,7,Down,1,177
P12_177_3,12,3,160,165,5,Down,1,177
P12_178_0,12,0,334,344,10,Down,2,178
P12_178_1,12,1,332,344,12,Down,2,178
P12_178_2,12,2,330,345,15,Down,2,178
P12_178_3,12,3,330,346,16,Down,3,178
P12_179_0,12,0,202,208,6,Down,2,179
P12_179_1,12,1,198,200,2,Down,1,179
P12_179_2,12,2,192,199,7,Down,1,179
P12_179_3,12,3,192,196,4,Down,1,179
P12_180_0,12,0,206,211,5,Down,2,180
P12_180_1,12,1,202,209,7,Down,1,180
P12_180_2,12,2,197,200,3,Down,1,180
P12_180_3,12,3,198,200,2,Down,1,180
P12_181_0,12,0,140,148,8,Down,1,181
P12_181_1,12,1,136,139,3,Down,1,181
P12_181_2,12,2,134,136,2,Down,1,181
P12_181_3,12,3,131,136,5,Down,1,181
P12_182_0,12,0,148,152,4,Down,1,182
P12_182_1,12,1,133,146,13,Down,1,182
P12_182_2,12,2,134,138,4,Down,1,182
P12_182_3,12,3,131,136,5,Down,1,182
P12_183_0,12,0,183,192,9,Down,1,183
P12_183_1,12,1,180,187,7,Down,1,183
P12_183_2,12,2,176,189,13,Down,2,183
P12_183_3,12,3,176,186,10,Down,1,183
P12_184_0,12,0,181,186,5,Down,1,184
P12_184_1,12,1,176,180,4,Down,1,184
P12_184_2,12,2,176,192,16,Down,3,184
P12_184_3,12,3,176,186,10,Down,2,184
P12_185_0,12,0,187,201,14,Down,1,185
P12_185_1,12,1,181,187,6,Down,1,185
P12_185_2,12,2,178,181,3,Down,1,185
P12_185_3,12,3,175,178,3,Down,1,185
P12_186_0,12,0,186,192,6,Down,1,186
P12_186_1,12,1,181,192,11,Down,1,186
P12_186_2,12,2,176,192,16,Down,2,186
P12_186_3,12,3,173,176,3,Down,1,186
P12_187_0,12,0,80,88,8,Down,1,187
P12_187_1,12,1,82,132,50,Down,3,187
P12_187_2,12,2,72,104,32,Down,3,187
P12_187_3,12,3,68,72,4,Down,1,187
P12_188_0,12,0,171,184,13,Down,2,188
P12_188_1,12,1,160,169,9,Down,1,188
P12_188_2,12,2,157,161,4,Down,1,188
P12_188_3,12,3,152,157,5,Down,1,188
P12_189_0,12,0,160,168,8,Down,1,189
P12_189_1,12,1,155,160,5,Down,1,189
P12_189_2,12,2,157,168,11,Down,2,189
P12_189_3,12,3,154,188,34,Down,3,189
P12_190_0,12,0,119,141,22,Down,3,190
P12_190_1,12,1,104,120,16,Down,2,190
P12_190_2,12,2,104,115,11,Down,2,190
P12_190_3,12,3,112,114,2,Down,1,190
P12_191_0,12,0,114,134,20,Down,2,191
P12_191_1,12,1,110,115,5,Down,1,191
P12_191_2,12,2,104,110,6,Down,1,191
P12_191_3,12,3,106,120,14,Down,2,191
P12_192_0,12,0,234,245,11,Down,2,192
P12_192_1,12,1,230,234,4,Down,1,192
P12_192_2,12,2,227,229,2,Down,1,192
P12_192_3,12,3,228,242,14,Down,2,192
P12_193_0,12,0,268,276,8,Down,2,193
P12_193_1,12,1,258,266,8,Down,1,193
P12_193_2,12,2,259,268,9,Down,2,193
P12_193_3,12,3,256,267,11,Down,2,193
P12_194_0,12,0,260,280,20,Down,3,194
P12_194_1,12,1,252,282,30,Down,3,194
P12_194_2,12,2,248,262,14,Down,2,194
P12_194_3,12,3,251,262,11,Down,2,194
P12_195_0,12,0,213,224,11,Down,1,195
P12_195_1,12,1,211,219,8,Down,2,195
P12_195_2,12,2,204,211,7,Down,1,195
P12_195_3,12,3,204,208,4,Down,2,195
P12_196_0,12,0,142,152,10,Down,1,196
P12_196_1,12,1,136,141,5,Down,1,196
P12_196_2,12,2,132,136,4,Down,1,196
P12_196_3,12,3,131,136,5,Down,1,196
P12_197_0,12,0,256,259,3,Down,1,197
P12_197_1,12,1,253,256,3,Down,1,197
P12_197_2,12,2,250,258,8,Down,2,197
P12_197_3,12,3,250,253,3,Down,1,197
P12_198_0,12,0,304,310,6,Down,1,198
P12_198_1,12,1,306,314,8,Down,2,198
P12_198_2,12,2,306,320,14,Down,2,198
P12_198_3,12,3,312,322,10,Down,2,198
P12_199_0,12,0,288,314,26,Down,3,199
P12_199_1,12,1,283,305,22,Down,2,199
P12_199_2,12,2,282,301,19,Down,3,199
P12_199_3,12,3,276,299,23,Down,3,199
P12_200_0,12,0,192,200,8,Down,2,200
P12_200_1,12,1,186,200,14,Down,3,200
P12_200_2,12,2,178,186,8,Down,1,200
P12_200_3,12,3,172,176,4,Down,1,200
P12_201_0,12,0,150,165,15,Down,2,201
P12_201_1,12,1,143,150,7,Down,1,201
P12_201_2,12,2,144,155,11,Down,2,201
P12_201_3,12,3,142,160,18,Down,2,201
P12_202_0,12,0,346,358,12,Down,2,202
P12_202_1,12,1,341,347,6,Down,2,202
P12_202_2,12,2,342,353,11,Down,2,202
P12_202_3,12,3,342,360,18,Down,2,202
P13_203_0,13,0,144,152,8,Down,2,203
P13_203_1,13,1,147,150,3,Down,1,203
P13_203_2,13,2,150,152,2,Down,1,203
P13_203_3,13,3,153,161,8,Down,2,203
P13_204_0,13,0,150,155,5,Down,2,204
P13_204_1,13,1,154,168,14,Down,2,204
P13_204_2,13,2,156,160,4,Down,2,204
P13_204_3,13,3,159,168,9,Down,2,204
P13_205_0,13,0,198,224,26,Down,3,205
P13_205_1,13,1,202,205,3,Down,1,205
P13_205_2,13,2,208,211,3,Down,1,205
P13_205_3,13,3,211,216,5,Down,2,205
P13_206_0,13,0,210,216,6,Down,1,206
P13_206_1,13,1,211,216,5,Down,2,206
P13_206_2,13,2,213,216,3,Down,1,206
P13_206_3,13,3,218,224,6,Down,2,206
P13_207_0,13,0,173,176,3,Down,1,207
P13_207_1,13,1,176,179,3,Down,1,207
P13_207_2,13,2,176,180,4,Down,1,207
P13_207_3,13,3,178,182,4,Down,1,207
P13_208_0,13,0,240,246,6,Down,1,208
P13_208_1,13,1,242,245,3,Down,1,208
P13_208_2,13,2,245,254,9,Down,1,208
P13_208_3,13,3,248,253,5,Down,1,208
P13_209_0,13,0,196,206,10,Down,1,209
P13_209_1,13,1,195,205,10,Down,1,209
P13_209_2,13,2,200,204,4,Down,1,209
P13_209_3,13,3,203,206,3,Down,1,209
P13_210_0,13,0,220,224,4,Down,1,210
P13_210_1,13,1,224,230,6,Down,1,210
P13_210_2,13,2,229,232,3,Down,1,210
P13_210_3,13,3,232,237,5,Down,1,210
P13_211_0,13,0,168,176,8,Down,1,211
P13_211_1,13,1,173,176,3,Down,1,211
P13_211_2,13,2,176,181,5,Down,1,211
P13_211_3,13,3,180,186,6,Down,1,211
P13_212_0,13,0,206,208,2,Down,1,212
P13_212_1,13,1,206,211,5,Down,1,212
P13_212_2,13,2,211,216,5,Down,1,212
P13_212_3,13,3,216,219,3,Down,1,212
P13_213_0,13,0,200,208,8,Down,1,213
P13_213_1,13,1,204,208,4,Down,1,213
P13_213_2,13,2,208,214,6,Down,1,213
P13_213_3,13,3,216,217,1,Down,1,213
P13_214_0,13,0,208,216,8,Down,1,214
P13_214_1,13,1,216,224,8,Down,2,214
P13_214_2,13,2,220,224,4,Down,1,214
P13_214_3,13,3,226,232,6,Down,1,214
P01_001_4,1,4,200,212,12,Down,2,1
P01_002_4,1,4,245,249,4,Down,1,2
P01_003_4,1,4,236,242,6,Down,2,3
P01_004_4,1,4,695,707,12,Up,2,4
P01_005_4,1,4,193,195,2,Down,1,5
P01_006_4,1,4,194,198,4,Down,1,6
P01_007_4,1,4,255,259,4,Down,1,7
P01_008_4,1,4,249,257,8,Down,2,8
P01_009_4,1,4,301,310,9,Down,2,9
P01_010_4,1,4,310,314,4,Down,2,10
P01_011_4,1,4,705,707,2,Up,1,11
P01_012_4,1,4,668,673,5,Up,2,12
P01_013_4,1,4,791,799,8,Up,2,13
P01_015_4,1,4,333,341,8,Down,2,15
P01_016_4,1,4,666,671,5,Up,2,16
P01_017_4,1,4,309,311,2,Down,2,17
P01_018_4,1,4,697,706,9,Up,2,18
P01_019_4,1,4,286,291,5,Down,2,19
P01_020_4,1,4,703,711,8,Up,2,20
P01_021_4,1,4,695,700,5,Up,2,21
P01_022_4,1,4,218,234,16,Down,2,22
P01_023_4,1,4,583,593,10,Up,2,23
P01_024_4,1,4,237,242,5,Down,2,24
P01_025_4,1,4,761,780,19,Up,2,25
P01_026_4,1,4,721,727,6,Up,1,26
P01_027_4,1,4,721,727,6,Up,1,27
P01_028_4,1,4,266,294,28,Down,2,28
P01_029_4,1,4,767,773,6,Up,2,29
P01_030_4,1,4,770,777,7,Up,1,30
P01_031_4,1,4,705,709,4,Up,2,31
P01_032_4,1,4,711,714,3,Up,1,32
P01_033_4,1,4,645,647,2,Up,1,33
P01_034_4,1,4,631,636,5,Up,2,34
P01_035_4,1,4,244,245,1,Down,1,35
P01_036_4,1,4,279,281,2,Down,1,36
P01_037_4,1,4,155,160,5,Down,1,37
P01_060_1,1,0,875,883,8,Up,2,60
P01_039_4,1,4,620,626,6,Up,1,39
P01_040_4,1,4,280,286,6,Down,2,40
P01_041_4,1,4,283,300,17,Down,3,41
P01_042_4,1,4,655,664,9,Up,1,42
P01_043_4,1,4,248,256,8,Down,2,43
P01_044_4,1,4,670,686,16,Up,2,44
P01_045_4,1,4,243,255,12,Down,2,45
P01_046_4,1,4,248,256,8,Down,2,46
P01_047_4,1,4,727,746,19,Up,2,47
P01_048_4,1,4,347,352,5,Down,1,48
P01_049_4,1,4,730,733,3,Up,1,49
P02_050_4,2,4,320,349,29,Down,3,50
P02_051_4,2,4,577,593,16,Up,2,51
P02_052_4,2,4,621,658,37,Up,3,52
P02_053_4,2,4,400,421,21,Down,3,53
P03_054_0,3,0,708,746,38,Up,3,54
P03_054_1,3,1,713,743,30,Up,3,54
P03_054_2,3,2,687,732,45,Up,3,54
P03_054_3,3,3,682,730,48,Up,3,54
P03_054_4,3,4,690,733,43,Up,3,54
P03_055_4,3,4,576,577,1,Down,3,55
P03_056_4,3,4,519,551,32,Up,3,56
P03_057_4,3,4,538,557,19,Up,3,57
P03_058_0,3,0,814,851,37,Up,3,58
P03_058_1,3,1,801,833,32,Up,3,58
P03_058_2,3,2,790,823,33,Up,3,58
P03_058_3,3,3,753,809,56,Up,3,58
P03_060_0,3,0,602,631,29,Up,3,60
P03_060_1,3,1,621,625,4,Up,1,60
P03_060_2,3,2,618,627,9,Up,2,60
P03_060_3,3,3,613,620,7,Up,2,60
P03_061_0,3,0,693,703,10,Up,3,61
P03_061_1,3,1,689,698,9,Up,3,61
P03_061_2,3,2,690,695,5,Up,2,61
P03_061_3,3,3,682,689,7,Up,2,61
P03_061_4,3,4,673,682,9,Up,3,61
P03_062_0,3,0,662,679,17,Up,2,62
P03_062_1,3,1,666,675,9,Up,2,62
P03_062_2,3,2,665,673,8,Up,2,62
P03_062_3,3,3,659,669,10,Up,2,62
P03_063_1,3,1,750,786,36,Up,3,63
P03_063_2,3,2,762,783,21,Up,3,63
P03_063_3,3,3,767,783,16,Up,3,63
P03_105_3,3,1,732,741,9,Up,2,105
P03_106_3,3,2,738,744,6,Up,2,106
P03_107_3,3,3,729,743,14,Up,2,107
P03_108_3,3,1,815,827,12,Up,3,108
P03_109_3,3,2,815,825,10,Up,2,109
P03_110_3,3,3,823,829,6,Up,2,110
P03_111_3,3,1,711,719,8,Up,1,111
P03_112_3,3,2,708,717,9,Up,2,112
P03_113_3,3,3,708,717,9,Up,2,113
P03_069_4,3,4,686,713,27,Up,3,69
P03_114_3,3,0,492,501,9,Up,3,114
P03_115_3,3,1,490,507,17,Up,3,115
P03_116_3,3,2,477,503,26,Up,3,116
P03_117_3,3,3,457,506,49,Up,3,117
P03_071_4,3,4,627,635,8,Up,2,71
P03_118_3,3,0,519,539,20,Up,3,118
P03_119_3,3,1,530,541,11,Up,3,119
P03_120_3,3,2,529,543,14,Up,3,120
P03_121_3,3,3,515,537,22,Up,3,121
P03_122_3,3,1,754,763,9,Up,2,122
P03_123_3,3,2,732,761,29,Up,3,123
P03_124_3,3,3,743,755,12,Up,2,124
P03_125_3,3,1,673,681,8,Up,2,125
P03_126_3,3,2,674,681,7,Up,2,126
P03_127_3,3,3,625,681,56,Up,3,127
P03_128_3,3,1,703,711,8,Up,2,128
P03_129_3,3,2,695,719,24,Up,3,129
P03_130_3,3,3,687,705,18,Up,3,130
P03_131_3,3,1,590,610,20,Up,3,131
P03_132_3,3,2,597,604,7,Up,2,132
P03_133_3,3,3,577,601,24,Up,3,133
P03_080_4,3,4,352,389,37,Down,3,80
P03_081_4,3,4,389,408,19,Down,3,81
P03_082_4,3,4,376,400,24,Down,2,82
P03_134_3,3,1,270,276,6,Down,2,134
P03_135_3,3,2,264,268,4,Down,2,135
P03_136_3,3,3,261,270,9,Down,2,136
P03_086_4,3,4,256,266,10,Down,3,86
P03_137_3,3,1,298,321,23,Down,3,137
P03_138_3,3,2,294,304,10,Down,2,138
P03_139_3,3,3,295,298,3,Down,2,139
P03_096_4,3,4,324,329,5,Down,1,96
P03_097_4,3,4,340,350,10,Down,2,97
P03_098_4,3,4,320,338,18,Down,3,98
P03_099_4,3,4,336,339,3,Down,2,99
P03_100_4,3,4,338,354,16,Down,3,100
P03_101_4,3,4,278,306,28,Down,3,101
P03_102_4,3,4,331,344,13,Down,3,102
P03_103_4,3,4,344,357,13,Down,2,103
P03_104_4,3,4,341,374,33,Down,3,104
P05_105_4,5,4,324,344,20,Down,2,105
P05_106_4,5,4,334,362,28,Down,2,106
P05_107_4,5,4,505,537,32,Up,3,107
P05_134_5,5,0,470,482,12,Up,2,134
P05_110_4,5,4,289,329,40,Down,3,110
P05_135_5,5,0,449,467,18,Down,2,135
P05_136_5,5,1,379,446,67,Down,3,136
P05_137_5,5,2,315,373,58,Down,3,137
P05_138_5,5,3,295,313,18,Down,2,138
P05_112_4,5,4,279,295,16,Down,2,112
P05_113_4,5,4,296,304,8,Down,1,113
P05_114_4,5,4,299,304,5,Down,1,114
P05_115_4,5,4,324,350,26,Down,2,115
P05_127_0,5,0,609,625,16,Up,2,127
P05_127_1,5,1,591,609,18,Up,2,127
P05_127_2,5,2,531,589,58,Up,3,127
P05_127_3,5,3,458,525,67,Up,3,127
P05_127_4,5,4,439,453,14,Up,2,127
P05_128_4,5,4,655,662,7,Up,1,128
P05_129_4,5,4,657,658,1,Up,1,129
P05_130_4,5,4,474,488,14,Up,2,130
P05_131_4,5,4,352,384,32,Down,2,131
P05_132_0,5,0,301,325,24,Up,2,132
P05_132_1,5,1,279,304,25,Up,2,132
P05_132_2,5,2,273,290,17,Up,2,132
P05_132_3,5,3,246,271,25,Up,2,132
P05_132_4,5,4,231,250,19,Up,2,132
P05_133_0,5,0,432,468,36,Down,3,133
P06_137_4,6,4,211,212,1,Down,1,137
P06_138_4,6,4,274,280,6,Down,1,138
P06_139_4,6,4,244,244,0,Down,1,139
P07_148_4,7,4,335,373,38,Up,3,148
P07_149_0,7,0,290,314,24,Down,2,149
P07_149_1,7,1,265,287,22,Down,2,149
P07_152_0,7,0,328,340,12,Up,2,152
P07_152_1,7,1,309,327,18,Up,2,152
P07_152_2,7,2,287,305,18,Up,2,152
P07_152_3,7,3,211,284,73,Up,3,152
P08_163_4,8,4,735,741,6,Up,1,163
P08_164_4,8,4,675,682,7,Up,1,164
P08_165_4,8,4,652,655,3,Up,1,165
P08_168_4,8,4,227,233,6,Down,2,168
P08_173_4,8,4,294,298,4,Down,1,173
P08_174_4,8,4,258,266,8,Down,2,174
P08_175_4,8,4,218,232,14,Down,2,175
P10_176_4,10,4,639,655,16,Up,2,176
P10_177_4,10,4,302,323,21,Down,3,177
P12_178_4,12,4,620,621,1,Down,3,178
P12_185_4,12,4,763,775,12,Up,2,185
P12_186_4,12,4,773,777,4,Up,2,186
P12_187_4,12,4,757,769,12,Up,1,187
P12_188_4,12,4,767,773,6,Up,1,188
P12_190_4,12,4,775,787,12,Up,2,190
P12_191_4,12,4,791,797,6,Up,1,191
P12_192_4,12,4,817,839,22,Up,3,192
P12_193_4,12,4,825,841,16,Up,3,193
P12_194_4,12,4,714,719,5,Up,1,194
P12_195_4,12,4,683,691,8,Up,2,195
P12_196_4,12,4,732,745,13,Up,2,196
P12_197_4,12,4,807,815,8,Up,1,197
P12_198_4,12,4,699,701,2,Up,1,198
P12_199_4,12,4,647,655,8,Up,1,199
P12_203_4,12,4,601,609,8,Up,3,203
P12_204_4,12,4,288,314,26,Down,3,204
P12_205_4,12,4,286,299,13,Down,2,205
P12_206_4,12,4,275,288,13,Down,2,206
P12_209_4,12,4,192,196,4,Down,1,209
P12_210_4,12,4,131,136,5,Down,1,210
P12_211_4,12,4,176,186,10,Down,2,211
P12_212_4,12,4,176,184,8,Down,1,212
P12_213_4,12,4,175,177,2,Down,1,213
P12_214_4,12,4,173,174,1,Down,1,214
P12_215_4,12,4,68,72,4,Down,1,215
P12_216_4,12,4,152,156,4,Down,1,216
P12_217_4,12,4,154,172,18,Down,2,217
P12_218_4,12,4,112,114,2,Down,1,218
P12_219_4,12,4,107,120,13,Down,2,219
P12_220_4,12,4,228,242,14,Down,2,220
P12_221_4,12,4,256,264,8,Down,2,221
P12_222_4,12,4,251,262,11,Down,2,222
P12_223_4,12,4,204,208,4,Down,1,223
P12_224_4,12,4,131,136,5,Down,1,224
P12_225_4,12,4,250,253,3,Down,2,225
P12_226_4,12,4,314,322,8,Down,2,226
P12_227_4,12,4,282,299,17,Down,3,227
P12_230_4,12,4,342,360,18,Down,3,230
